wwwwwwww
e   w  w
ww    ww
w      w
w  w   w
w      s
wwwwwwww